00000000000000000000
01110100001111000000
01001111101011111110
01311010001010010010
00101011101011110010
01101110001010011110
00001011001011110100
01111101001010010100
00100101101011110110
01101100111010010010
00000000001011110110
01111111111110010110
01000001000010010010
01000101001010011110
01111101111110200010
00010000010000100010
00010011010001100110
00110010011001011100
01100111110111110110
00000000000000000000