0000000000
0100111110
0131101000
0010101110
0110111000
0000101100
0111110100
0010010110
0110110012
0000000000