000000000000000
010011111010110
013110100010100
001010111010110
011011100010100
000010110010110
011111010010100
001001011010110
011011001110100
000000000010110
011111111111100
010000010000100
010002010010100
011111011111100
000000000000000