0000000000000000000000000
0111011111111111111311110
0101010000010100000010010
0100111110101111111010110
0111101000101001001011010
0010101110101111001010110
0110111000101001111011010
0000101100101111010010110
0111110100101001010011010
0010010110101111011010110
0110110011101001001011010
0000000000101111011010110
0111111111111001011011010
0100000100001001001010110
0100010100101001111011010
0111110111111010001010110
0001000001000010001011010
0001001101000110011010110
0011001001100101110011010
0110011111011111011010110
0101110000010000010011010
0101011111110111110010010
0111110000100100000010010
0101111111111111111111110
0200000000000000000000000