000000000000000000000000000000
010011111010111111101011011110
011110100010100100101101010010
001010111010111100101021010010
011011100010100111101101010010
000010110010111101001011010010
011111010010100101001101010010
001001011010111101101011010010
011011001110100100101101010010
000000000010111101101011010010
011111111111100101101101010010
010000010000100100101011010010
010001010010100111101101010010
011111011111101000101011010010
000100000100001000101101010010
000100110100011001101011010010
001100100110010111001101010010
011001111101111101101011010010
010111000001000001001101010010
010101111111011111001001010010
011111000010010000001001010010
010111111111111111111111010010
010000000000000000000100010010
011111111111111111111111110010
010000100001000010000000010010
010001110011100011010001010110
010111010111011101110111011100
010010010101010101010101010100
031110011101110111011101110110
000000000000000000000000000000